...................................................
...................................................
........................*****......................
........................*****......................
......................**...**......................
.....................**....**......................
..........................**.......................
.........................**........................
........................**.........................
.......................**..........................
......................**...........................
.....................**............................
....................**.............................
...................**..............................
...................*************...................
...................*************...................
...................................................
...................................................
...................................................
...................................................
