...................................................
...................................................
......................******.......................
......................******.......................
....................**......**.....................
...................**.......**.....................
............................**.....................
..........................**.......................
........................**.........................
..........................***......................
.............................**....................
.............................**....................
..................**.........**....................
...................**.......**.....................
.....................*******.......................
.....................*******.......................
...................................................
...................................................
...................................................
...................................................